11111111111111111111111
10100010111011100101111
1000000P000000000001111
10111010111110010111011
11111110111010100001011
11111111111111111111111