111111111
10CE000P1
111111111
